{
  "levels" : {"level0" : [[".", ".", ".", ".", ".", ".", ".", ".", ".", "0"],
          [".", ".", ".", ".", ".", ".", ".", ".", ".", "1"],
          [".", ".", ".", ".", ".", ".", ".", ".", ".", "2"],
          [".", ".", ".", ".", ".", ".", ".", ".", ".", "3"],
          [".", ".", ".", ".", "#", ".", ".", ".", ".", "4"],
          [".", ".", ".", ".", ".", ".", ".", ".", ".", "5"],
          [".", ".", ".", ".", ".", ".", ".", ".", ".", "6"],
          [".", ".", ".", ".", ".", ".", ".", ".", ".", "7"],
          [".", ".", ".", ".", ".", ".", ".", ".", ".", "8"]
         ], "level1" : [[".", ".", ".", ".", ".", ".", ".", ".", ".", "0"],
          [".", ".", "@", "@", "@", "@", "@", ".", ".", "1"],
          [".", ".", "#", "#", "#", "#", "#", ".", ".", "2"],
          [".", ".", "#", "#", "#", "#", "#", ".", ".", "3"],
          [".", ".", "#", "#", "#", "#", "#", ".", ".", "4"],
          [".", ".", ".", ".", ".", ".", ".", ".", ".", "5"],
          [".", ".", ".", ".", ".", ".", ".", ".", ".", "6"],
          [".", ".", ".", ".", ".", ".", ".", ".", ".", "7"],
          [".", ".", ".", ".", ".", ".", ".", ".", ".", "8"]
         ], "level2" : [[".", ".", ".", ".", ".", ".", ".", ".", ".", "0"],
          [".", ".", "@", "@", "@", "@", "@", ".", ".", "1"],
          [".", ".", "#", "#", "#", "#", "#", ".", ".", "2"],
          [".", ".", "#", "#", "#", "#", "#", ".", ".", "3"],
          [".", ".", "$", "$", "$", "$", "$", ".", ".", "4"],
          [".", ".", ".", ".", ".", ".", ".", ".", ".", "5"],
          [".", ".", ".", ".", ".", ".", ".", ".", ".", "6"],
          [".", ".", ".", ".", ".", ".", ".", ".", ".", "7"],
          [".", ".", ".", ".", ".", ".", ".", ".", ".", "8"]
         ]}
}